10 X 10
**********
*S     ***
******   *
*****   **
*   ***  *
* *      *
*  *******
**  ******
***    F**
**********