20 X 20
********************
*                  *
*  ***** ********* *
*   ****     *     *
*** ******** * **  *
*F* *****    * *** *
* *     * **** *   *
* ******* * **** ***
*    **** * ****S  *
* ****  * * ********
* **** ** *        *
* **** ** * **** ***
* **** ** * **** *** 
* **** **** ******** 
* *       *        *
* *** *** ******** *
*   *   * *        *
** **** * * ********
**                 *
****************** *
********************       

