10 x 10
**********
*S       *
**** *** *
*F*  * * *
* * ** * *
* * *  * *
* *   ** *
* *****  *
*       **
**********