10 x 15
***************
* ****    *   *
*      **** ***
***** ** **  S*
* F** ** **  **
* **  *       *
*  * ** *******
**    * *******
*  **         *
***************
