10 x 10
**********
*s *     *
*    * * *
*** **** *
*   *  * *
***** ** *
*  F*    *
* *** ****
*        *
**********