10 x 15
***************
*      *      *
* **** * **** *
*   F* * **** *
****** *   *  *
*    * *S* * **
* ** * *** * **
* **** *** * **
*          *  *
***************