20 x 20
********************
**   **     **** S**
*  ***  ******   ***
****    *****  *****
****  *       ******
**    ****** **   **
** **     **  **  **
**** * ****  *     *
*       ***     * **
*****  ****  ****  *
*     *       ***  *
****   ******   ** *
***  *    ****  *  *
**  * ** ****  ** **
***   **  *   *  ***
*****F *  ***   ****
***   ******  ******
**  ***   **      **
***     *    *******
********************